------------------
------------------
------------------
------------------
------------------
---------------}--
--{------------X--
XXXXX--------XXXXX
