-----------------------------
-----------------------------
--------------S--------------
----------<>-----<>----------
----------[]-----[]----------
----------[]-----[]----------
-------S--[]-----[]--S-------
----------[]-----[]-------}--
--{-------[]-----[]-------X--
XXXXXX--XXXXXXXXXXXXX--XXXXXX
