------------------
------------------
------------------
------------------
------------------
------<-----------
------[-----------
------[]----------
------[]----------
------[]----------
------[]----------
------[]-------}--
--{---[]-------X--
XXXXXXXXXXX--XXXXX
