--------------------------------
--------------------------------
--------------------------------
------------,,,,,,,-------------
-----------,,,,,,,,,------------
----------,,,,,,,,,,,-----------
----------,,,,,,,,,,,-----------
----------,,,,,,,,,,,-----------
----------,,,,,,,,,,,-----------
----------,,,,,,,,,,,-----------
-----------,,,,,,,,,------------
----------XX,,,,,,,----------}--
--{------XXXX----------------X--
XXXXX--XXXXXX------------XXXXXXX
