----------------------------------------------------------------------------------------------------------------------------------------------------------------------------------------------------------
----------------------------------------------------------------------------------------------------------------------------------------------------------------------------------------------------------
----------------------------------------------------------------------------------------------------------------------------------------------------------------------------------------------------------
----------------------------------------------------------------------------------------------------------------------------------------------------------------------------------------------------------
----------------------------------------------------------------------------------------------------------------------------------------------------------------------------------------------------------
----------------------Q---------------------------------------------------------SSSSSSSS---SSSQ--------------Q-----------SSS----SQQS--------------------------------------------------------XX------------
-------------------------------------------------------------------------------------------------------------------------------------------------------------------------------------------XXX------------
------------------------------------------------------------------------------------------------------------------------------------------------------------------------------------------XXXX------------
-----------------------------------------------------------------------------------------------------------------------------------------------------------------------------------------XXXXX------------
----------------Q---SQSQS---------------------<>---------<>------------------SQS--------------S-----S-----Q--Q--Q-----S----------SS------X--X----------XX--X------------SSQS------------XXXXXX------------
--------------------------------------<>------[]---------[]-----------------------------------------------------------------------------XX--XX--------XXX--XX--------------------------XXXXXXX------------
----------------------------<>--------[]------[]---------[]----------------------------------------------------------------------------XXX--XXX------XXXX--XXX-----<>--------------<>-XXXXXXXX------------
----------------------------[]--------[]------[]---------[]---------------------------------------------------------------------------XXXX--XXXX----XXXXX--XXXX----[]--------------[]XXXXXXXXX--------X---
YYYYYYYYYYYYYYYYYYYYYYYYYYYYYYYYYYYYYYYYYYYYYYYYYYYYYYYYYYYYYYYYYYYYY--YYYYYYYYYYYYYYY---YYYYYYYYYYYYYYYYYYYYYYYYYYYYYYYYYYYYYYYYYYYYYYYYYYYYYYYYYYYYYYYY--YYYYYYYYYYYYYYYYYYYYYYYYYYYYYYYYYYYYYYYYYYYYYYY
