----------------------------------------------------------------------------------------------------------------------------------------------------------------------------------------------------------------------------------------------------------------------------------------
----------------------------------------------------------------------------------------------------------------------------------------------------------------------------------------------------------------------------------------------------------------------------------------
--------------------------------------------------------------------------------------------------------------------------------QQ------------------------------------------------------------------------------------------------------------------------------------------------XX----
---------------------------------------------------------------------------------------------------------------------------------------------------------------------------------------------------------------------------------------------------------------------------------XXX----
--------------------------------------------------------------------------------------------------------------------------------------------------------------------------------------------------------------------------------------------------------------------------------XXXX----
--------------------------------------------------------------------------------SSSSSS-----------------------------------------------------------------------------------------------------------------------------------------------------------------------------------------XXXXX----
----------------------------------Q------------------------------------------------------------Q------------------------------QQQQQQ------------------------------------------Q---------------------------------------Q-------------------------------------------------------XXXXXX----
-------------------------------------------------------------------QSQSQ------<>-----------------------------------------------------------------------------------------------------------QSQSQ------<>---------------------------------------------------------SSS---------XXXXXXX----
------------------------------------------------------------------------------[]----------------------------------------------------------------------------------------------------------------------[]--------------------------------------------------------------------------------
-----Q----------------Q----------------------Q--------------------------------[]-------------------------Q---------------------------------------Q----------------Q-----------------------------------[]--Q----------------------Q-----------------------------------------XXXXXXXXX----
------------------------------------------------------------------------------[]--Q-----------SSS---------------------------XXXXXXXXXX----------------------------------------------------------------[]------------------------------------------------------------------XXXXXXXXXX----
----------------------------------XX-------------------------XXXXXXXXXXXXXXXXXXX----------------------------------------------------------------------------------------------XX-----XXXXXXXXXXXXXXXXXXX--------------XX---------------------------------------XXXXXX----------XXXXX----
-<>------------------------<>-----XX-----<>------------------XXXXXXXXXXXXXXXXXXX---------------------<>--------------------------------------<>------------------------<>-----XX-----XXXXXXXXXXXXXXXXXXX-------<>-----XX-----<>---------------------------XXXXXXXXXXX---XXXXXXXXXXXX----
-[]--{---------------------[]-----XX-----[]------------------XXXXXXXXXXXXXXXXXXX---------------------[]--------------------------------------[]------------------------[]-----XX-----XXXXXXXXXXXXXXXXXXX-------[]-----XX-----[]---------------------------XXXXXXXXXXX--XXXXXXXXXXXXX--}-
XXXXXXXXXXXXXXXXXXXXXXXXXXXXXXXXXXXXXXXXXXXXXXXXXXXXXXXXXXXXXXXXXXXXXXXXXXXXXXXXXXXXXXXXX--XXXXXXXXXXXXXXXXXXXXXXXXXXXXXXXXXXXXXXXXXXXXXXX--XXXXXXXXXXXXXXXXXXXXXXXXXXXXXXXXXXXXXXXXXXXXXXXXXXXXXXXXXXXXXXXXXXXXXXXXXXXXXXXXXXXXXXXXXXXXXXXXXXXXXXXXXXX---XXXXXXXXXXX--XXXXXXXXXXXXXXXXX
XXXXXXXXXXXXXXXXXXXXXXXXXXXXXXXXXXXXXXXXXXXXXXXXXXXXXXXXXXXXXXXXXXXXXXXXXXXXXXXXXXXXXXXXX--XXXXXXXXXXXXXXXXXXXXXXXXXXXXXXXXXXXXXXXXXXXXXXX--XXXXXXXXXXXXXXXXXXXXXXXXXXXXXXXXXXXXXXXXXXXXXXXXXXXXXXXXXXXXXXXXXXXXXXXXXXXXXXXXXXXXXXXXXXXXXXXXXXXXXXXXXXX---XXXXXXXXXXX--XXXXXXXXXXXXXXXXX
