----------------------------------------------------------------------------------------------------------------------------------------------------------------------------------------------------------------------------------------------------------------------------------------
----------------------------------------------------------------------------------------------------------------------------------------------------------------------------------------------------------------------------------------------------------------------------------------
--------------------------------------------------------------------------------------------------------------------------------QQ------------------------------------------------------------------------------------------------------------------------------------------------OO----
---------------------------------------------------------------------------------------------------------------------------------------------------------------------------------------------------------------------------------------------------------------------------------OOO----
--------------------------------------------------------------------------------------------------------------------------------------------------------------------------------------------------------------------------------------------------------------------------------OOOO----
--------------------------------------------------------------------------------SSSSSS-----------------------------------------------------------------------------------------------------------------------------------------------------------------------------------------OOOOO----
----------------------------------Q------------------------------------------------------------Q------------------------------QQQQQQ------------------------------------------Q---------------------------------------Q-------------------------------------------------------OOOOOO----
-------------------------------------------------------------------QSQSQ------<>-----------------------------------------------------------------------------------------------------------QSQSQ------<>---------------------------------------------------------SSS---------OOOOOOO----
------------------------------------------------------------------------------[]----------------------------------------------------------------------------------------------------------------------[]--------------------------------------------------------------------------------
-----Q----------------Q----------------------Q--------------------------------[]-------------------------Q---------------------------------------Q----------------Q-----------------------------------[]--Q----------------------Q-----------------------------------------OOOOOOOOO----
------------------------------------------------------------------------------[]--Q-----------SSS---------------------------XXXXXXXXXX----------------------------------------------------------------[]------------------------------------------------------------------OOOOOOOOOO----
----------------------------------OO-------------------------XXXXXXXXXXXXXXXXXXX----------------------------------------------------------------------------------------------OO-----XXXXXXXXXXXXXXXXXXX--------------OO---------------------------------------OOOOOO----------OOOOO----
-<>------------------------<>-----OO-----<>------------------XXXXXXXXXXXXXXXXXXX---------------------<>--------------------------------------<>------------------------<>-----OO-----XXXXXXXXXXXXXXXXXXX-------<>-----OO-----<>---------------------------OOOOOOOOOOO---OOOOOOOOOOOO----
-[]------------------------[]-----OO-----[]------------------XXXXXXXXXXXXXXXXXXX---------------------[]--------------------------------------[]------------------------[]-----OO-----XXXXXXXXXXXXXXXXXXX-------[]-----OO-----[]---------------------------OOOOOOOOOOO--OOOOOOOOOOOOO----
XXXXXXXXXXXXXXXXXXXXXXXXXXXXXXXXXXXXXXXXXXXXXXXXXXXXXXXXXXXXXXXXXXXXXXXXXXXXXXXXXXXXXXXXXX-XXXXXXXXXXXXXXXXXXXXXXXXXXXXXXXXXXXXXXXXXXXXXXXX-XXXXXXXXXXXXXXXXXXXXXXXXXXXXXXXXXXXXXXXXXXXXXXXXXXXXXXXXXXXXXXXXXXXXXXXXXXXXXXXXXXXXXXXXXXXXXXXXXXXXXXXXXXXX--XXXXXXXXXXX--XXXXXXXXXXXXXXXXX
XXXXXXXXXXXXXXXXXXXXXXXXXXXXXXXXXXXXXXXXXXXXXXXXXXXXXXXXXXXXXXXXXXXXXXXXXXXXXXXXXXXXXXXXXX-XXXXXXXXXXXXXXXXXXXXXXXXXXXXXXXXXXXXXXXXXXXXXXXX-XXXXXXXXXXXXXXXXXXXXXXXXXXXXXXXXXXXXXXXXXXXXXXXXXXXXXXXXXXXXXXXXXXXXXXXXXXXXXXXXXXXXXXXXXXXXXXXXXXXXXXXXXXXX--XXXXXXXXXXX--XXXXXXXXXXXXXXXXX
