                WWWWWWWWWWWWWWWWWWWWWWWWWWWWWWWW                                                
                WWWWWWWWWWWWWWWWWWWWWWWWWWWWWWWW                                                
                WW------------WWWW------------WW                                                
                WW------B-----WWWW-PPP----PPP-WW                                                
                WW-----B-B----DWWD-P--------P-WW                                                
                WW----B-S-B---DWWD-P-PPPPPP-P-WW                                                
                WW-----B-B----DWWD-P--------P-WW                                                
                WW------B-----WWWW-PPP----PPP-WW                                                
                WW------------WWWW------------WW                                                
                WWWWWWWWWWWWWWWWWWWWWWWDDWWWWWWW                                                
                WWWWWWWWWWWWWWWWWWWWWWWWWWWWWWWW                                                
                                WWWWWWWWWWWWWWWW                WWWWWWWWWWWWWWWWWWWWWWWWWWWWWWWW
                                WWWWWWWDDWWWWWWW                WWWWWWWWWWWWWWWWWWWWWWWWWWWWWWWW
                                WWPPPPP--PPPPPWW                WW-------BBBBBWWWW------------WW
                                WWP---P----P-PWW                WW---------BBBWWWW-BBBBBBBBBB-WW
                                WWP-P-P-PP-P-PWW                WW----------BBDWWD-B--M--M--B-WW
                                WW--P-P--P-P--WW                WW------------DWWD-B-M----M-B-WW
                                WWP-P-PP-P-P-PWW                WW----------BBDWWD-B--------B-WW
                                WWP-P----P---PWW                WW---------BBBWWWW-BBBB--BBBB-WW
                                WWPPPPP--PPPPPWW                WW-------BBBBBWWWW------------WW
                                WWWWWWWDDWWWWWWW                WWWWWWWDDWWWWWWWWWWWWWWWWWWWWWWW
                                WWWWWWWWWWWWWWWW                WWWWWWWWWWWWWWWWWWWWWWWWWWWWWWWW
WWWWWWWWWWWWWWWWWWWWWWWWWWWWWWWWWWWWWWWWWWWWWWWWWWWWWWWWWWWWWWWWWWWWWWWWWWWWWWWW                
WWWWWWWWWWWWWWWWWWWWWWWWWWWWWWWWWWWWWWWDDWWWWWWWWWWWWWWWWWWWWWWWWWWWWWWDDWWWWWWW                
WW------------WWWW------------WWWW------------WWWW------------WWWW------------WW                
WW------------WWWW------------WWWW-BB------BB-WWWW------------WWWW-B-B-BB-B-B-WW                
WW------------DWWD------------DWWD------------DWWD--B------B--DWWD------------WW                
WW------------DWWD-----B------DWWD-----BB-----DWWD------------DWWD-B-B-BB-B-B-WW                
WW------------DWWD------------DWWD------------DWWD--B------B--DWWD------------WW                
WW------------WWWW------------WWWW-BB------BB-WWWW------------WWWW-B-B-BB-B-B-WW                
WW------------WWWW------------WWWW------------WWWW------------WWWW------------WW                
WWWWWWWWWWWWWWWWWWWWWWWDDWWWWWWWWWWWWWWWWWWWWWWWWWWWWWWWWWWWWWWWWWWWWWWWWWWWWWWW                
WWWWWWWWWWWWWWWWWWWWWWWWWWWWWWWWWWWWWWWWWWWWWWWWWWWWWWWWWWWWWWWWWWWWWWWWWWWWWWWW                
                WWWWWWWWWWWWWWWWWWWWWWWWWWWWWWWWWWWWWWWWWWWWWWWW                                
                WWWWWWWDDWWWWWWWWWWWWWWWWWWWWWWWWWWWWWWWWWWWWWWW                                
                WW------------WWWW------------WWWW------------WW                                
                WW------------WWWW------------WWWW--B------B--WW                                
                WW-----BB-----DWWD--B------B--DWWD------------WW                                
                WW-----BB-----DWWD------------DWWD------------WW                                
                WW-----BB-----DWWD--B------B--DWWD------------WW                                
                WW------------WWWW------------WWWW--B------B--WW                                
                WW------------WWWW------------WWWW------------WW                                
                WWWWWWWWWWWWWWWWWWWWWWWDDWWWWWWWWWWWWWWWWWWWWWWW                                
                WWWWWWWWWWWWWWWWWWWWWWWWWWWWWWWWWWWWWWWWWWWWWWWW                                
                                WWWWWWWWWWWWWWWW                                                
                                WWWWWWWDDWWWWWWW                                                
                                WW------------WW                                                
                                WW------------WW                                                
                                WW-----BB-----WW                                                
                                WW-----BB-----WW                                                
                                WW-----BB-----WW                                                
                                WW------------WW                                                
                                WW------------WW                                                
                                WWWWWWWDDWWWWWWW                                                
                                WWWWWWWWWWWWWWWW                                                
                WWWWWWWWWWWWWWWWWWWWWWWWWWWWWWWWWWWWWWWWWWWWWWWW                                
                WWWWWWWWWWWWWWWWWWWWWWWDDWWWWWWWWWWWWWWWWWWWWWWW                                
                WW------------WWWW------------WWWW------------WW                                
                WW------------WWWW-M--M--M--M-WWWW------------WW                                
                WW------------DWWD------------DWWD--BB----BB--WW                                
                WW------------DWWD-M--M--M--M-DWWD--BB----BB--WW                                
                WW------------DWWD-----OO-----DWWD--BB----BB--WW                                
                WW------------WWWW-M-OMOOMO-M-WWWW------------WW                                
                WW------------WWWW---OOOOOO---WWWW------------WW                                
                WWWWWWWWWWWWWWWWWWWWWWWDDWWWWWWWWWWWWWWWWWWWWWWW                                
                WWWWWWWWWWWWWWWWWWWWWWWWWWWWWWWWWWWWWWWWWWWWWWWW                                
