                WWWWWWWWWWWWWWWWWWWWWWWWWWWWWWWW                                                
                WWWWWWWWWWWWWWWWWWWWWWWWWWWWWWWW                                                
                WW------------WWWW------------WW                                                
                WW------B-----WWWW-PPP----PPP-WW                                                
                WW-----B-B----WWWW-P--------P-WW                                                
                WW----B-S-B---LLLL-P-PPPPPP-P-WW                                                
                WW-----B-B----WWWW-P--------P-WW                                                
                WW------B-----WWWW-PPP----PPP-WW                                                
                WW------------WWWW------------WW                                                
                WWWWWWWWWWWWWWWWWWWWWWWLLWWWWWWW                                                
                WWWWWWWWWWWWWWWWWWWWWWWLLWWWWWWW                                                
                                WWWWWWWLLWWWWWWW                WWWWWWWWWWWWWWWWWWWWWWWWWWWWWWWW
                                WWWWWWWLLWWWWWWW                WWWWWWWWWWWWWWWWWWWWWWWWWWWWWWWW
                                WWPPPPP--PPPPPWW                WW-------BBBBBWWWW------------WW
                                WWP---P----P-PWW                WW---------BBBWWWW-BBBBBBBBBB-WW
                                WWP-P-P-PP-P-PWW                WW----------BBWWWW-B--M--M--B-WW
                                WW--P-P--P-P--WW                WW------------DDDD-B-M-}--M-B-WW
                                WWP-P-PP-P-P-PWW                WW----------BBWWWW-B--------B-WW
                                WWP-P----P---PWW                WW---------BBBWWWW-BBBB--BBBB-WW
                                WWPPPPP--PPPPPWW                WW-------BBBBBWWWW------------WW
                                WWWWWWWDDWWWWWWW                WWWWWWWLLWWWWWWWWWWWWWWWWWWWWWWW
                                WWWWWWWDDWWWWWWW                WWWWWWWLLWWWWWWWWWWWWWWWWWWWWWWW
WWWWWWWWWWWWWWWWWWWWWWWWWWWWWWWWWWWWWWWDDWWWWWWWWWWWWWWWWWWWWWWWWWWWWWWLLWWWWWWW                
WWWWWWWWWWWWWWWWWWWWWWWWWWWWWWWWWWWWWWWDDWWWWWWWWWWWWWWWWWWWWWWWWWWWWWWLLWWWWWWW                
WW------------WWWW------------WWWW------------WWWW------------WWWW------------WW                
WW------------WWWW------------WWWW-BB------BB-WWWW------------WWWW-B-B-BB-B-B-WW                
WW------------WWWW------------WWWW------------WWWW--B------B--WWWW------------WW                
WW------------DDDD-----B------DDDD-----BB-----LLLL------------DDDD-B-B-BB-B-B-WW                
WW------------WWWW------------WWWW------------WWWW--B------B--WWWW------------WW                
WW------------WWWW------------WWWW-BB------BB-WWWW------------WWWW-B-B-BB-B-B-WW                
WW------------WWWW------------WWWW------------WWWW------------WWWW------------WW                
WWWWWWWWWWWWWWWWWWWWWWWLLWWWWWWWWWWWWWWWWWWWWWWWWWWWWWWWWWWWWWWWWWWWWWWWWWWWWWWW                
WWWWWWWWWWWWWWWWWWWWWWWLLWWWWWWWWWWWWWWWWWWWWWWWWWWWWWWWWWWWWWWWWWWWWWWWWWWWWWWW                
                WWWWWWWLLWWWWWWWWWWWWWWWWWWWWWWWWWWWWWWWWWWWWWWW                                
                WWWWWWWLLWWWWWWWWWWWWWWWWWWWWWWWWWWWWWWWWWWWWWWW                                
                WW------------WWWW------------WWWW------------WW                                
                WW------------WWWW------------WWWW--B------B--WW                                
                WW-----BB-----WWWW--B------B--WWWW------------WW                                
                WW-----BB-----DDDD------------DDDD------------WW                                
                WW-----BB-----WWWW--B------B--WWWW------------WW                                
                WW------------WWWW------------WWWW--B------B--WW                                
                WW------------WWWW------------WWWW------------WW                                
                WWWWWWWWWWWWWWWWWWWWWWWDDWWWWWWWWWWWWWWWWWWWWWWW                                
                WWWWWWWWWWWWWWWWWWWWWWWDDWWWWWWWWWWWWWWWWWWWWWWW                                
                                WWWWWWWDDWWWWWWW                                                
                                WWWWWWWDDWWWWWWW                                                
                                WW------------WW                                                
                                WW------------WW                                                
                                WW-----BB-----WW                                                
                                WW-----BB-----WW                                                
                                WW-----BB-----WW                                                
                                WW------------WW                                                
                                WW------------WW                                                
                                WWWWWWWLLWWWWWWW                                                
                                WWWWWWWLLWWWWWWW                                                
                WWWWWWWWWWWWWWWWWWWWWWWLLWWWWWWWWWWWWWWWWWWWWWWW                                
                WWWWWWWWWWWWWWWWWWWWWWWLLWWWWWWWWWWWWWWWWWWWWWWW                                
                WW------------WWWW------------WWWW------------WW                                
                WW------------WWWW-M--M--M--M-WWWW------------WW                                
                WW------------WWWW------------WWWW--BB----BB--WW                                
                WW------------DDDD-M--M--M--M-DDDD--BB----BB--WW                                
                WW------------WWWW-----OO-----WWWW--BB----BB--WW                                
                WW------------WWWW-M-OMOOMO-M-WWWW------------WW                                
                WW------------WWWW---OOO{OO---WWWW------------WW                                
                WWWWWWWWWWWWWWWWWWWWWWWEEWWWWWWWWWWWWWWWWWWWWWWW                                
                WWWWWWWWWWWWWWWWWWWWWWWEEWWWWWWWWWWWWWWWWWWWWWWW                                
