XXXXXXXXXXXXXXXXX
X~~~X~~~:---X---X
X~~~X~~~X---X---X
X~~~X~~~:---X---X
X~~~X~~~X---X---X
XXXXXXXXXXXXXXXXX
Xo~~~~~~X%-----+X
X~~~~~~~X-------X
Xo~~~~~~X%-----+X
X~~~~~~~X-------X
X~~~~~~~X------@X
X~~~~~~~X-------X
X~~~~~~~X------@X
XXXXXXXXXXXXXXXXX
