XXXXX
X*XXX
XX$XX
XXXoX
XXXXX
