XXXXXXXXXXX
Xo---o---oX
X---------X
X---------X
X----a----X
X---------X
X---------X
XXX----XXXX
X---------X
X---------X
X----X---XX
X---------X
X---------X
X@---@----X
XXXXXXXXXXX
