XXXXXXXXXXXXXXXX+++++++++++++XXXXXXX
X-----------(-)--------------------X
X------------------------XXX-------X
X-------(-)------------------------X
X--------------------XXX-----------X
X---(-)----------------------------X
X----------------XXX---------------X
Xv--------------------------------oX
XXXXXXXXXXXXXXXX+++++++++++++XXXXXXX
