XXXXXXXXXXXX
X-X-XX-XXX-X
XX--------XX
XX-X-XXXX--X
XX--------XX
X--X-XXXX-XX
XX-X-XXXX--X
XX-X-XXXX-XX
X--X-XXXX-XX
XX--------XX
X-XXX-XX-X-X
XXXXXXXXXXXX
XXXXXXXXXXXX
X{--------}X
XXXXXXXXXXXX
XXXXXXXXXXXX
X----------X
X-XXX-XX-X-X
XXXXXXXXXXXX
