XXXXXXXXXXXXXXXX
X-X-XX-XXX-XX{-X
XX--------XXX--X
XX-X-XXXX--XX--X
XX--------XXX--X
X--X-XXXX-XXX--X
XX-X-XXXX--XX-}X
XX-X-XXXX-XXXXXX
X--X-XXXX-XXXXXX
XX--------XXX--X
X-XXX-XX-X-XX--X
XXXXXXXXXXXXX--X
