----------------------------------------------------------------
----------------------------------------------------------------
----------------------------------------------------------------
-----------------------------------------------SSSS-------------
----------------------------------------------------------------
---------SQSQS--S---SS---SSSS------Q---SQQS----SSSS-------------
----------------------------------------------------------------
----------------------------------------------------------------
---------------------------------------------------------XX-----
--------------------------<>----------------------------XXX-----
---------------------<>---[]-----X--X-------X--X-------XXXX-----
----------------<>---[]---[]----XX--XX-----XX--XX-----XXXXX-----
-{--------------[]---[]---[]---XXX--XXX---XXX--XXX---XXXXXX---}-
YYYYR--LYYR---LYYYYYYYYYYYYYYYYYYYYYYYYYYYYYR--LYYYYYYYYYYYYYYYY
