----------------------------------------------------------------
----------------------------------------------------------------
----------------------------------------------------------------
-----------------------------------------------XXXX-------------
----------------------------------------------------------------
---------XQXQX--X---XX---XXXX------Q---XQQX----XXXX-------------
----------------------------------------------------------------
----------------------------------------------------------------
---------------------------------------------------------XX-----
--------------------------<>----------------------------XXX-----
---------------------<>---[]-----X--X-------X--X-------XXXX-----
----------------<>---[]---[]----XX--XX-----XX--XX-----XXXXX-----
-{--------------[]---[]---[]---XXX--XXX---XXX--XXX---XXXXXX---}-
XXXXX--XXXX---XXXXXXXXXXXXXXXXXXXXXXXXXXXXXXX--XXXXXXXXXXXXXXXXX
