WWWWWWWWWWWWWWWWWWWWWWWWWWWWWWWWWWWWWWWWWWWWW
WWWWWWWWWWWWWWWWWWWWWWWWWWWWWWWWWWWWWWWWWWWWW
WW-----------WWWW-----------WWWW-----{-----WW
WW-----------WWWW-----------WWWW-----------WW
WW-----------WWWW-----------WWWW-----------WW
WW--Y--------------------------------------WW
WW-----------WWWW-----------WWWW-----------WW
WW-----------WWWW-----------WWWW-----------WW
WW-----------WWWW-----------WWWW-----------WW
WWWWWWW-WWWWWWWWWWWWWWWWWWWWWWWWWWWWW-WWWWWWW
WWWWWWW-WWWWWWWWWWWWWWWWWWWWWWWWWWWWW-WWWWWWW
WWWWWWW-WWWWWWWWWWWWWWWWWWWWWWWWWWWWW-WWWWWWW
WWWWWWW-WWWWWWWWWWWWWWWWWWWWWWWWWWWWW-WWWWWWW
WW-----------WWWW-----------WWWW-----------WW
WW-----------WWWW-----------WWWW-----------WW
WW-----------WWWW-----------WWWW-----------WW
WW-----------WWWW--------------------------WW
WW-----------WWWW-----------WWWW-----------WW
WW-----------WWWW-----------WWWW-----------WW
WW-----------WWWW-----------WWWW-----------WW
WWWWWWWWWWWWWWWWWWWWWW-WWWWWWWWWWWWWWWWWWWWWW
WWWWWWWWWWWWWWWWWWWWWW-WWWWWWWWWWWWWWWWWWWWWW
WWWWWWWWWWWWWWWWWWWWWW-WWWWWWWWWWWWWWWWWWWWWW
WWWWWWWWWWWWWWWWWWWWWW-WWWWWWWWWWWWWWWWWWWWWW
WW--Y-----Y--WWWW-----------WWWW-----------WW
WW-----------WWWW-----------WWWW-----------WW
WW-----------WWWW-----------WWWW--Y-----Y--WW
WW-----}-------------------------Y-Y---Y-Y-WW
WW-----------WWWW-----------WWWW--Y-----Y--WW
WW-----------WWWW-----------WWWW-----------WW
WW-----------WWWW-----------WWWW-----------WW
WWWWWWWWWWWWWWWWWWWWWWWWWWWWWWWWWWWWWWWWWWWWW
WWWWWWWWWWWWWWWWWWWWWWWWWWWWWWWWWWWWWWWWWWWWW
