XXXXXXXXXXXXXXXX
XXXXX}XXXXXXXXXX
XXXXX-XXXXXXXXXX
XXXXX-XXXXXXXXXX
XXXX--XXXXXXXXXX
XXXX----XXXXXXXX
XXXX----XXXXXXXX
XXXX----XXXXXXXX
XXXX----XXXXXXXX
XXXX----XXXXXXXX
XXXX----XXXXXXXX
XXXX-XXXXXXXXXXX
XXXX-XXXXXXXXXXX
XXX---XXXXXXXXXX
XXX---XXXXXXXXXX
XXX---XXXXXXXXXX
XXX---XXXXXXXXXX
XXXX-XXXXXXXXXXX
XXXX-XXX----XXXX
XXXX-XXX----XXXX
XXXX--------XXXX
XXXXXXXXXX-XXXXX
XXXXXXXXXX-XXXXX
XXXXXXXXXX---XXX
XXXXXXXX-----XXX
XXXXXXXX-----XXX
XXXXXXXX-{---XXX
XXXXXXXXXXXXXXXX
