XXXXXXXXXXXXXXX
XXXXXXXXXXXXXXX
XXXXXXXX}XXXXXX
XXXXXXXX-XXXXXX
XXXXXXXX-XXXXXX
XXX------XXXXXX
XXXXXXXX-XXXXXX
XXXXXXXX-XXXXXX
XXXXXX-----XXXX
XXXXXX-----XXXX
XXXXXX-----XXXX
XXXXXXXX-----XX
XXXXXXXX-----XX
XXXXXXXX##---XX
XXXXXXXX-----XX
XXXXXXX--XXX-XX
XXX------XXX-XX
XXXXXXX--XXX-XX
XXXXXXX--XXX-XX
XXXXXXX--XXX-XX
XXXXXXX--XXX-XX
XXXXX--------XX
XXXXX-----XX-XX
XXXXX-----XX-XX
XXXXXX-##--XXXX
XXXXXX------XXX
XXXXXX--{---XXX
XXXXXXXXXXXXXXX
XXXXXXXXXXXXXXX
