XXXXXXX--XXXXXXX
XXXXX}X--XXXXXXX
XXXXX-X--XXXXXXX
XXXXX-X--XXXXXXX
XXXX--X--XXXXXXX
XXXX-----XXXXXXX
XXXX-----XXXXXXX
XXXX-----XXXXXXX
XXXX-----XXXXXXX
----------------
----------------
XXXX-XXXXXXXXXXX
XXXX-XXXXXXXXXXX
XXX---XXXXXXXXXX
XXX---XXXXXXXXXX
XXX---XXXXXXXXXX
XXX---XXXXXXXXXX
XXXX-XXXXXXXXXXX
XXXX-XXX----XXXX
XXXX-XXX----XXXX
XXXX--------XXXX
XXXXXXXXXX-XXXXX
XXXXXXXXXX-XXXXX
XXXXXXXXXX---XXX
XXXXXXXX-----XXX
XXXXXXXX-----XXX
XXXXXXXX-{---XXX
XXXXXXXXXXX--XXX
