XXXXXXXXXXXXXXXX
----------------
-------}--------
-XX--XXXXX--XXX-
-XX--XXXXX--XXX-
----------------
-----------XX---
XXXXXX-----XX---
XXXXXX---XXXXXXX
---------XXXXXXX
----------------
XXXXXXXX---XX---
XXXXXXXX---XX---
---------XXXXXXX
---------XXXXXXX
-XXX--XX--------
-XXX--XX--------
-----------XX---
-----------XX---
----XXXX--------
----XXXX--------
-----------XX---
-----------XX---
---{-------XX---
XXXXXXXXXXXXXXXX
