X-XX-X
X----X
XXXXXX
-{X---
XXX-XX
--X---
X-XXXX
X-XX}X
X-XX-X
